 MMMMMMM            MMMMM
 MMMMMMM            MMMMM
 M                      M
 M                      M
 M                      M
 M                      M
 M                      M
 M                      M
 M                      M
 M                      M
 M                      M
 M            S         M
 M                  S   M
 M                MMM   M
 M     S      MMM       M
 M    MMM MMM       MM  M
 M           W          M
 MMMMMMMMMMMMMMMMMMMMMMMM